; converted using KrisszConvert by Michael Kamensky
; colors used: #000000 #ffffff #5c5a81 #c2e4a4

[BDCFF]
[game]
Name=CSO #174 - Guillotine
Description=A converted Krissz Engine cave
Author=Dustin
WWW=
Date=2021-08-15
Charset=Original
Fontset=Original
Levels=1
Caves=1

[cave]
Name=CSO #174
Intermission=false
CaveTime=30
DiamondsRequired=2
DiamondValue=100 0
AmoebaTime=60
MagicWallTime=20
BorderProperties.wraparound=false
BorderProperties.lineshift=false
Size=7 11
TargetFps=7.5
MagicWallStopsAmoeba=true
RockfordBirthTime=20
AmoebaLimit=200
AmoebaGrowsBeforeSpawn=true
NoTimeLimit=false
ReverseTime=false
OpenHorizontalBorders=false
OpenVerticalBorders=false
ValueOfASecond=1
SingleLife=true
KrisszSlimePermeability=6
Colors=#000000 #000000 #c2e4a4 #5c5a81 #ffffff #ffffff #ffffff

[map]
WWWWWWW
W  O  W
W.....W
WWrPrWW
WWr.rWW
WWr.rWW
WWr.rWW
W.d.d.W
W.rrr.W
WWWXWWW
WWWWWWW
[/map]
[/cave]

[/game]
[/BDCFF]
