; converted using KrisszConvert by Michael Kamensky
; colors used: #000000 #49bffa #a89754 #9c3f09

[BDCFF]
[game]
Name=Arno 566
Description=A converted Krissz Engine cave
Author=Arno
WWW=
Date=2017-08-08
Charset=Original
Fontset=Original
Levels=1
Caves=1

[cave]
Name=Arno 566
Intermission=false
CaveTime=450
DiamondsRequired=92
DiamondValue=100 0
AmoebaTime=60
MagicWallTime=20
BorderProperties.wraparound=false
BorderProperties.lineshift=false
Size=5 100
TargetFps=7.0
MagicWallStopsAmoeba=true
RockfordBirthTime=20
AmoebaLimit=200
AmoebaGrowsBeforeSpawn=true
NoTimeLimit=false
ReverseTime=false
OpenHorizontalBorders=false
OpenVerticalBorders=false
ValueOfASecond=1
SingleLife=true
KrisszSlimePermeability=6
Colors=#000000 #000000 #9c3f09 #a89754 #49bffa #49bffa #49bffa

[map]
WWWWW
WdrrW
WrdrW
W.d.W
Wr.dW
W.rdW
Wd..W
W.rdW
Wr.rW
W.drW
Wd..W
WrddW
Wd..W
W.rdW
Wd.dW
W.r.W
W..rW
Wr.dW
Wd.dW
W.drW
W.d.W
Wr.rW
W..dW
W.d.W
Wd.rW
W.d.W
Wrr.W
W.ddW
Wr.rW
W.ddW
Wdd.W
W..rW
WrddW
W.d.W
Wr.rW
Wd..W
W.d.W
Wr.dW
Wd.rW
W.d.W
WrrdW
Wd..W
W.rrW
W.ddW
Wd..W
Wd.rW
WrrdW
Wr.dW
W.d.W
Wr.rW
W.rdW
Wd..W
W.drW
Wr..W
W.rrW
W.ddW
Wd..W
WrddW
W.drW
Wdr.W
W.rdW
W..rW
W.drW
Wrd.W
Wd.rW
W.ddW
Wd.rW
WdrdW
W..dW
Wrd.W
W..rW
Wdd.W
W.ddW
Wr.dW
W.r.W
WdddW
Wd.rW
W.r.W
WrdrW
W...W
W.rdW
Wr.rW
W.ddW
Wdr.W
Wr.dW
W..rW
WrdrW
W.r.W
W.ddW
Wr.dW
Wd.rW
WdrrW
W.r.W
Wr.rW
W.d.W
WrrrW
W.d.W
W..rW
WPd.W
WWXWW
[/map]
[/cave]

[/game]
[/BDCFF]
