; converted using KrisszConvert by Michael Kamensky
; colors used: #000000 #ffffff #af80d8 #55426f

[BDCFF]
[game]
Name=DSM Alter Retro Cave N
Description=A converted Krissz Engine cave
Author=DarkStoorM
WWW=
Date=2020-05-02
Charset=Original
Fontset=Original
Levels=1
Caves=1

[cave]
Name=DSM Alter Retro Cave N
Intermission=false
CaveTime=150
DiamondsRequired=50
DiamondValue=8 20
AmoebaTime=60
MagicWallTime=20
BorderProperties.wraparound=false
BorderProperties.lineshift=false
Size=40 22
TargetFps=7.5
MagicWallStopsAmoeba=true
RockfordBirthTime=20
AmoebaLimit=200
AmoebaGrowsBeforeSpawn=false
NoTimeLimit=false
ReverseTime=false
OpenHorizontalBorders=false
OpenVerticalBorders=false
ValueOfASecond=1
SingleLife=true
KrisszSlimePermeability=6
Colors=#000000 #000000 #55426f #af80d8 #ffffff #ffffff #ffffff

[map]
WWWWWWWWWWWWWWWWWWWWWWWWWWWWWWWWWWWWWWWW
W......................................W
W......................................W
W......................................W
W......................................W
W.....P................................W
W...............  q.  q.  q.  q.  q.  qW
W...............   .   .   .   .   .   W
W...............Q  .Q  .Q  .Q  .Q  .Q  W
W................r...r...r...r...r...r.W
Wc. . . . . ...........................W
W . . . . . ...........................W
W .c. . . . ...........................W
W . . . . . ...........................W
W . .c. . . ...........................W
W . . . . . ...........................W
W . . .c. . ...........................W
W . . . . . ...........................W
W . . . .c. ...........................W
W . . . . . ...........................W
W . . . . .c...........................X
WWWWWWWWWWWWWWWWWWWWWWWWWWWWWWWWWWWWWWWW

[/map]
[/cave]

[/game]
[/BDCFF]
