; converted using KrisszConvert by Michael Kamensky
; colors used: #000000 #ffffff #94cc75 #518e3e

[BDCFF]
[game]
Name=DSM Dash 004
Description=A converted Krissz Engine cave
Author=DarkStoorM
WWW=
Date=2021-11-18
Charset=Original
Fontset=Original
Levels=1
Caves=1

[cave]
Name=DSM Dash 004
Intermission=false
CaveTime=150
DiamondsRequired=35
DiamondValue=6 10
AmoebaTime=10
MagicWallTime=150
BorderProperties.wraparound=false
BorderProperties.lineshift=false
Size=40 22
TargetFps=7.5
MagicWallStopsAmoeba=true
RockfordBirthTime=20
AmoebaLimit=200
AmoebaGrowsBeforeSpawn=false
NoTimeLimit=false
ReverseTime=false
OpenHorizontalBorders=false
OpenVerticalBorders=false
ValueOfASecond=1
SingleLife=true
KrisszSlimePermeability=1
Colors=#000000 #000000 #518e3e #94cc75 #ffffff #ffffff #ffffff

[map]
WWWWWWWWWWWWWWWWWWWWWWWWWWWWWWWWWWWWWWWW
WdrddrrWWWrrdrrdWWWWWWWWdrddrrWWWdrrrdrW
WrdrddrWWWrrdrrdWWWWWWWWdrrrdrWWWrrdrdrW
WddrrdrWWWdrrddrWWWWWWWWdrrrrdWWWrrdrddW
WrrrrdrWWWddrrrrWWWWWWWWrddrrrWWWdddrrdW
WrddrrdWWWrddrrdWWWWWWWWddrrrrWWWdddrrdW
WrddrrrWWWdrddrrWWWWWWWWddddrdWWWdddrrdW
W......................................W
W                                      W
WMMMMMM   MMMMMM   PX   MMMMMM   MMMMMMW
W                                      W
W M       M M  w         M   w     M  wW
W    w       M                       M W
W M M      w  M                   w M  W
W  M  w                  M  M    M     W
W w         M              w M         W
W                       M          M   W
W   wM    M               w            W
WM                                     W
W                                    M W
W                                      W
WWWWWWWWWWWWWWWWWWWWWWWWWWWWWWWWWWWWWWWW

[/map]
[/cave]

[/game]
[/BDCFF]
