; converted using KrisszConvert by Michael Kamensky
; colors used: #000000 #ffffff #abc4a0 #61849e

[BDCFF]
[game]
Name=DSM Dash 005
Description=A converted Krissz Engine cave
Author=DarkStoorM
WWW=
Date=2021-11-18
Charset=Original
Fontset=Original
Levels=1
Caves=1

[cave]
Name=DSM Dash 005
Intermission=false
CaveTime=250
DiamondsRequired=99
DiamondValue=4 7
AmoebaTime=60
MagicWallTime=20
BorderProperties.wraparound=false
BorderProperties.lineshift=false
Size=40 22
TargetFps=7.5
MagicWallStopsAmoeba=true
RockfordBirthTime=20
AmoebaLimit=200
AmoebaGrowsBeforeSpawn=false
NoTimeLimit=false
ReverseTime=false
OpenHorizontalBorders=false
OpenVerticalBorders=false
ValueOfASecond=1
SingleLife=true
KrisszSlimePermeability=6
Colors=#000000 #000000 #61849e #abc4a0 #ffffff #ffffff #ffffff

[map]
WWWWWWWWWWWWWWWWWWWWWWWWWWWWWWWWWWWWWWWW
W......dd.......rd.....r..dddd..d....d.W
Wd.Xd.c..d..c..rr..Q.d.rr..d.d..d......W
Wd.....d....ddrrr..Q.d.rrr...d....d....W
W.d.d...c..d.rrrr....dQrrrr...c.....d..W
WWWWWWWWWWrrrrrrrrrrrrrrrrrrrrWWWWWWWWWW
Wd.dd....WrrrrrrrrrrrrrrrrrrrrWcc......W
Wd.dd....WrrrrrrrrrrrrrrrrrrrrW...d.dd.W
W...d..Q.WrrrrrrrrrrrrrrrrrrrrW...d.dd.W
W......d.Wrrr...c..........rrrW.c.d..d.W
W.d...d..Wrr..d.d...........rrW...d..d.W
W........Wr....d........ddcd.rW...cd...W
W...d..Q.W....c.........ddcd..W....c...W
WrrrrrrrrrrrrrrrrrrrrrrrrrrrrrrrrrrrrrrW
WrrrrrrrrrrrrrrrrrrrrrrrrrrrrrrrrrrrrrrW
WrrrrrrrrrrrrrrrrrrrrrrrrrrrrrrrrrrrrrrW
W..........Qd.....c.d..c.Q....d..d.d...W
Wcd.........d...Q....d.....d...d.......W
Wcd..P......cd..d........d......d.dd...W
W.c..d........d.....d.cc........d.dd...W
W....d...d........d......d.d.......d...W
WWWWWWWWWWWWWWWWWWWWWWWWWWWWWWWWWWWWWWWW

[/map]
[/cave]

[/game]
[/BDCFF]
