; converted using KrisszConvert by Michael Kamensky
; colors used: #000000 #ffffff #cc78ee #9f3e8e

[BDCFF]
[game]
Name=DSM Alter Retro Cave D
Description=A converted Krissz Engine cave
Author=DarkStoorM
WWW=
Date=2020-05-02
Charset=Original
Fontset=Original
Levels=1
Caves=1

[cave]
Name=DSM Alter Retro Cave D
Intermission=false
CaveTime=200
DiamondsRequired=54
DiamondValue=7 20
AmoebaTime=60
MagicWallTime=20
BorderProperties.wraparound=false
BorderProperties.lineshift=false
Size=40 22
TargetFps=7.5
MagicWallStopsAmoeba=true
RockfordBirthTime=20
AmoebaLimit=200
AmoebaGrowsBeforeSpawn=false
NoTimeLimit=false
ReverseTime=false
OpenHorizontalBorders=false
OpenVerticalBorders=false
ValueOfASecond=1
SingleLife=true
KrisszSlimePermeability=6
Colors=#000000 #000000 #9f3e8e #cc78ee #ffffff #ffffff #ffffff

[map]
WWWWWWWWWWWWWWWWWWWWWWWWWWWWWWWWWWWWWWWW
W......................................W
W......................................W
W...................................P..W
W......  ..  ..  ..  ..  ..  ..  ..r...W
W......C ..C ..C ..C ..C ..C ..C ......W
W......................................W
W......................................W
W......r....r.......r...........r......W
W...r..r...............r............r..W
W....r........r.....r......r..r........W
W..................r.....r.......r.....W
W...............r...................r..W
W............................r.....r...W
W....r....r............................W
X...............r......................W
W.........................r............W
W......................................W
W......................................W
W......................................W
W......................................W
WWWWWWWWWWWWWWWWWWWWWWWWWWWWWWWWWWWWWWWW

[/map]
[/cave]

[/game]
[/BDCFF]
